===========
=....^.o..=
=#######.#=
=.........=
===========