===========
=.^..=.o..=
=####=##.#=
=.o^.##...=
===========